90000000000000000009
04444444411444444440
04000000000000000040
04000000000000000040
01000000000003000010
01000000000000000010
04000000000000000040
04000000000000000040
04444444411444444440
90000000000000000009
1
10 5
14.0 6.0 6