90000000000000000019
00024444411444444011
00020000000000003000
02200000000000000340
04000000000000000040
04000000000000000040
04300000000000000340
00030000000000003000
11044444411444444011
91000000000000000019
2
10 5
14.0 6.0 6