91666666666666666619
11044444411444444011
60030000000000003006
64300000000000000346
64000000000000000046
64000000000000000046
64300000000000000346
60030000000000003006
11044444411444444011
91666666666666666619
3
10 5
14.0 6.0 6